{
  "gameWindow": {
    "ORIGINAL_TILE_SIZE": 16,
    "SCALE": 3,
    "MAX_SCREEN_COLUMNS": 16,
    "MAX_SCREEN_ROWS": 12,
    "MAX_WORLD_COLUMNS": 50,
    "MAX_WORLD_ROWS": 50,
    "FPS": 60
  },
  "map": {
    "tiles": [
      [4, 4, 4, 4, 4, 4, 4, 4, 4, 4, 4, 4, 4, 4, 4, 4, 4, 4, 4, 4, 4, 4, 4, 4, 4, 4, 4, 4, 4, 4, 4, 4, 4, 4, 4, 4, 4, 4, 4, 4, 4, 4, 4, 4, 4, 4, 4, 4, 4, 4],
      [4, 1, 0, 2, 0, 4, 4, 0, 4, 4, 4, 0, 0, 4, 4, 4, 4, 4, 4, 4, 4, 4, 1, 0, 2, 2, 2, 0, 0, 2, 0, 2, 4, 4, 4, 4, 4, 4, 4, 4, 4, 3, 3, 3, 3, 3, 3, 3, 3, 4],
      [4, 2, 2, 0, 0, 2, 0, 2, 4, 4, 4, 4, 0, 4, 4, 4, 4, 4, 4, 4, 4, 4, 0, 2, 0, 4, 4, 4, 4, 4, 4, 4, 4, 4, 4, 4, 4, 4, 4, 4, 4, 3, 3, 3, 3, 3, 3, 3, 3, 4],
      [4, 0, 0, 2, 2, 0, 2, 0, 4, 4, 4, 4, 0, 0, 2, 0, 2, 0, 0, 2, 0, 2, 2, 0, 2, 2, 0, 0, 2, 0, 2, 0, 0, 2, 0, 2, 0, 0, 2, 0, 4, 3, 3, 3, 3, 3, 3, 3, 3, 4],
      [4, 2, 0, 2, 0, 4, 0, 2, 4, 4, 4, 4, 2, 0, 0, 2, 0, 2, 0, 0, 2, 0, 2, 0, 0, 2, 0, 2, 2, 0, 2, 2, 0, 2, 0, 2, 0, 2, 0, 0, 2, 3, 3, 3, 3, 3, 3, 3, 3, 4],
      [4, 4, 4, 4, 4, 4, 2, 0, 2, 0, 2, 0, 0, 0, 5, 4, 4, 4, 4, 4, 4, 4, 4, 4, 4, 4, 4, 4, 4, 4, 4, 4, 4, 4, 4, 4, 4, 1, 2, 4, 4, 3, 3, 3, 3, 3, 3, 3, 3, 4],
      [4, 4, 4, 4, 4, 4, 0, 2, 2, 0, 2, 0, 2, 5, 5, 4, 4, 4, 4, 4, 4, 4, 4, 4, 4, 4, 4, 4, 4, 4, 4, 4, 4, 4, 4, 4, 4, 4, 0, 0, 4, 4, 4, 4, 4, 4, 4, 4, 2, 4],
      [4, 0, 0, 0, 2, 0, 0, 4, 4, 4, 4, 4, 4, 4, 5, 4, 2, 0, 2, 3, 3, 3, 3, 3, 3, 0, 2, 0, 4, 4, 4, 4, 4, 4, 4, 4, 4, 4, 2, 2, 0, 2, 2, 0, 2, 2, 4, 4, 0, 4],
      [4, 4, 4, 4, 4, 4, 4, 4, 4, 4, 4, 4, 4, 4, 5, 5, 2, 4, 4, 3, 3, 3, 3, 3, 3, 0, 2, 0, 4, 4, 4, 4, 4, 4, 4, 4, 4, 4, 4, 2, 2, 0, 2, 2, 0, 2, 2, 0, 2, 4],
      [4, 4, 4, 4, 4, 4, 4, 4, 4, 4, 4, 4, 4, 4, 4, 4, 4, 4, 4, 3, 3, 3, 3, 3, 3, 4, 2, 0, 5, 5, 2, 0, 0, 2, 0, 2, 2, 0, 2, 0, 2, 0, 2, 0, 4, 4, 4, 4, 4, 4],
      [4, 4, 0, 2, 4, 4, 4, 4, 4, 4, 4, 4, 4, 4, 4, 4, 4, 4, 4, 3, 3, 3, 3, 3, 3, 4, 2, 0, 4, 4, 2, 0, 2, 0, 0, 2, 2, 0, 2, 0, 2, 0, 2, 0, 4, 4, 4, 4, 4, 4],
      [4, 4, 2, 0, 4, 4, 4, 4, 4, 4, 4, 4, 4, 4, 4, 4, 4, 4, 4, 4, 4, 4, 4, 4, 4, 4, 0, 2, 4, 4, 0, 2, 4, 4, 4, 4, 4, 4, 4, 4, 4, 4, 4, 4, 4, 4, 3, 3, 4, 4],
      [4, 4, 2, 0, 2, 0, 0, 2, 0, 2, 0, 0, 2, 0, 2, 0, 0, 2, 0, 2, 0, 0, 2, 0, 2, 0, 0, 2, 0, 2, 0, 0, 2, 0, 4, 4, 4, 4, 4, 4, 4, 4, 4, 4, 3, 3, 3, 4, 4, 4],
      [4, 4, 4, 2, 2, 0, 0, 2, 0, 2, 0, 0, 2, 0, 2, 0, 0, 2, 0, 2, 0, 0, 2, 0, 2, 0, 0, 2, 0, 2, 0, 0, 2, 0, 2, 0, 0, 2, 0, 2, 0, 0, 2, 0, 3, 3, 3, 3, 3, 4],
      [4, 4, 4, 2, 4, 4, 4, 4, 4, 4, 4, 4, 4, 4, 4, 4, 4, 4, 4, 2, 0, 0, 4, 4, 4, 4, 4, 4, 4, 4, 4, 4, 4, 0, 2, 0, 0, 2, 0, 2, 0, 0, 2, 0, 3, 3, 3, 3, 3, 4],
      [4, 2, 2, 2, 2, 0, 0, 2, 0, 2, 0, 4, 4, 4, 4, 4, 4, 4, 4, 2, 0, 0, 4, 4, 4, 4, 4, 4, 4, 4, 4, 4, 4, 0, 4, 4, 4, 4, 4, 4, 4, 4, 4, 4, 3, 3, 3, 3, 4, 4],
      [4, 2, 2, 0, 4, 4, 4, 4, 4, 4, 4, 4, 4, 4, 4, 4, 4, 4, 4, 2, 0, 0, 4, 4, 4, 4, 4, 4, 4, 4, 4, 4, 4, 5, 4, 4, 4, 4, 4, 4, 4, 4, 4, 4, 3, 3, 3, 4, 4, 4],
      [4, 4, 4, 2, 4, 4, 4, 4, 4, 4, 4, 4, 1, 2, 0, 4, 4, 0, 2, 0, 0, 2, 0, 2, 4, 4, 2, 0, 1, 4, 4, 4, 4, 5, 4, 4, 4, 4, 4, 4, 4, 4, 4, 4, 3, 3, 3, 3, 4, 4],
      [4, 4, 4, 0, 4, 4, 4, 4, 4, 4, 4, 4, 2, 2, 0, 4, 4, 0, 2, 0, 0, 2, 0, 2, 4, 4, 2, 0, 2, 4, 4, 4, 4, 5, 4, 4, 4, 4, 4, 4, 4, 4, 4, 4, 4, 4, 4, 4, 4, 4],
      [4, 4, 2, 0, 2, 0, 0, 2, 0, 2, 0, 0, 2, 2, 2, 4, 4, 2, 0, 2, 0, 0, 2, 0, 4, 4, 0, 2, 0, 2, 0, 2, 0, 0, 2, 0, 2, 2, 4, 4, 4, 4, 4, 4, 4, 4, 4, 4, 4, 4],
      [4, 4, 2, 0, 2, 0, 0, 2, 0, 2, 0, 0, 2, 2, 0, 0, 2, 0, 2, 0, 0, 2, 0, 2, 0, 0, 2, 0, 2, 2, 0, 2, 0, 0, 2, 0, 2, 2, 4, 4, 4, 4, 4, 4, 4, 4, 4, 4, 4, 4],
      [4, 4, 0, 4, 4, 4, 4, 4, 4, 4, 4, 4, 2, 2, 0, 0, 2, 0, 4, 0, 0, 2, 4, 2, 0, 0, 2, 0, 2, 4, 4, 4, 4, 4, 4, 4, 2, 2, 2, 0, 0, 2, 0, 4, 4, 4, 4, 4, 4, 4],
      [4, 4, 2, 2, 2, 0, 0, 2, 2, 4, 4, 4, 2, 4, 0, 0, 2, 0, 4, 0, 0, 2, 4, 2, 0, 0, 2, 4, 2, 4, 4, 4, 4, 2, 0, 2, 2, 2, 2, 0, 0, 2, 0, 4, 4, 4, 4, 4, 4, 4],
      [4, 4, 4, 1, 4, 4, 4, 4, 2, 1, 1, 2, 1, 2, 0, 0, 2, 0, 2, 0, 0, 2, 0, 2, 0, 0, 2, 0, 1, 4, 4, 4, 4, 0, 4, 4, 4, 4, 4, 4, 4, 2, 0, 4, 4, 4, 4, 4, 4, 4],
      [4, 4, 4, 2, 4, 4, 4, 4, 4, 4, 4, 4, 4, 4, 4, 4, 4, 4, 4, 0, 0, 2, 4, 4, 4, 4, 4, 4, 2, 4, 4, 4, 4, 2, 4, 4, 4, 4, 4, 3, 3, 3, 3, 3, 3, 4, 4, 4, 4, 4],
      [4, 4, 4, 4, 4, 4, 4, 4, 4, 4, 4, 4, 4, 4, 4, 4, 4, 4, 4, 0, 0, 2, 4, 4, 4, 4, 2, 0, 2, 4, 4, 4, 4, 5, 4, 4, 4, 4, 4, 3, 3, 3, 3, 3, 3, 4, 4, 4, 4, 4],
      [4, 4, 4, 4, 4, 3, 3, 4, 4, 4, 4, 4, 4, 4, 4, 2, 4, 4, 4, 4, 5, 4, 4, 4, 4, 4, 0, 4, 4, 4, 4, 4, 4, 5, 4, 4, 4, 4, 4, 3, 3, 3, 3, 3, 3, 3, 3, 3, 4, 4],
      [4, 4, 4, 4, 4, 3, 3, 4, 4, 4, 4, 4, 4, 4, 4, 2, 2, 2, 2, 4, 2, 4, 4, 4, 4, 4, 2, 4, 4, 4, 0, 2, 2, 0, 2, 2, 0, 2, 2, 3, 3, 3, 3, 3, 3, 3, 3, 3, 4, 4],
      [4, 4, 4, 3, 3, 3, 3, 4, 4, 4, 4, 4, 4, 4, 4, 4, 4, 4, 2, 2, 2, 2, 2, 2, 2, 2, 0, 4, 4, 0, 2, 2, 0, 2, 2, 0, 2, 2, 2, 3, 3, 3, 3, 3, 3, 4, 4, 4, 4, 4],
      [4, 4, 4, 3, 3, 3, 3, 0, 2, 2, 0, 0, 2, 2, 0, 4, 4, 4, 4, 4, 2, 4, 4, 4, 4, 4, 4, 4, 4, 0, 2, 2, 4, 4, 4, 4, 4, 4, 4, 4, 4, 3, 3, 4, 4, 4, 4, 4, 4, 4],
      [4, 4, 4, 3, 3, 3, 3, 0, 2, 2, 0, 0, 2, 2, 0, 4, 4, 4, 4, 4, 4, 4, 4, 4, 4, 4, 4, 4, 4, 0, 2, 2, 4, 4, 4, 4, 4, 4, 4, 4, 4, 3, 3, 3, 3, 4, 4, 4, 4, 4],
      [4, 4, 4, 3, 3, 3, 3, 4, 4, 2, 2, 4, 4, 2, 0, 0, 2, 0, 2, 0, 0, 2, 0, 2, 0, 0, 2, 0, 2, 0, 2, 2, 4, 4, 4, 4, 4, 4, 4, 4, 4, 4, 3, 3, 3, 4, 4, 4, 4, 4],
      [4, 4, 4, 3, 3, 4, 4, 4, 4, 4, 2, 4, 4, 2, 0, 0, 2, 0, 2, 0, 0, 2, 0, 2, 0, 0, 2, 0, 2, 0, 2, 2, 4, 4, 4, 4, 4, 4, 4, 4, 4, 4, 4, 4, 4, 4, 4, 4, 4, 4],
      [4, 3, 3, 3, 3, 4, 4, 4, 4, 4, 2, 2, 4, 4, 4, 4, 4, 4, 4, 4, 4, 4, 4, 4, 4, 4, 4, 4, 4, 0, 2, 2, 4, 4, 4, 4, 4, 4, 4, 4, 4, 4, 4, 4, 4, 4, 4, 4, 4, 4],
      [4, 3, 3, 3, 4, 4, 4, 4, 4, 4, 4, 2, 4, 0, 2, 4, 4, 4, 4, 4, 4, 4, 4, 4, 4, 4, 4, 4, 4, 0, 2, 2, 0, 0, 2, 0, 2, 0, 0, 2, 0, 2, 0, 0, 2, 0, 2, 4, 4, 4],
      [4, 4, 4, 2, 4, 4, 4, 4, 4, 4, 4, 2, 2, 2, 0, 4, 4, 4, 4, 4, 4, 4, 4, 4, 4, 4, 4, 4, 4, 0, 2, 2, 0, 0, 2, 0, 2, 0, 0, 2, 0, 2, 0, 0, 2, 0, 2, 4, 4, 4],
      [4, 4, 4, 2, 4, 4, 4, 4, 4, 4, 4, 4, 4, 4, 4, 4, 4, 4, 4, 4, 4, 4, 4, 4, 4, 4, 4, 4, 4, 4, 4, 4, 4, 4, 4, 4, 2, 4, 4, 4, 4, 4, 4, 4, 4, 4, 2, 4, 4, 4],
      [4, 2, 4, 2, 2, 2, 4, 4, 4, 4, 4, 4, 4, 4, 4, 4, 4, 4, 4, 4, 4, 4, 4, 4, 4, 4, 4, 4, 4, 4, 4, 4, 4, 4, 4, 4, 2, 4, 4, 2, 2, 4, 4, 4, 4, 4, 2, 2, 2, 4],
      [4, 2, 4, 2, 4, 4, 4, 4, 4, 4, 4, 4, 4, 4, 0, 2, 2, 0, 0, 2, 0, 2, 0, 0, 2, 0, 2, 0, 0, 2, 0, 0, 4, 4, 4, 4, 0, 2, 0, 2, 2, 0, 0, 2, 5, 5, 0, 2, 2, 4],
      [4, 2, 2, 2, 4, 4, 4, 4, 4, 4, 4, 4, 4, 4, 0, 2, 2, 0, 0, 2, 0, 2, 0, 0, 2, 0, 2, 0, 0, 2, 0, 2, 4, 4, 4, 4, 4, 4, 4, 4, 4, 4, 4, 4, 4, 4, 0, 4, 4, 4],
      [4, 2, 2, 2, 4, 4, 4, 4, 4, 4, 4, 4, 4, 4, 0, 2, 4, 4, 4, 4, 4, 4, 4, 2, 4, 4, 4, 4, 0, 2, 4, 4, 4, 4, 4, 4, 4, 4, 4, 4, 4, 4, 4, 4, 4, 4, 2, 4, 4, 4],
      [4, 4, 4, 4, 4, 3, 3, 3, 3, 3, 3, 3, 3, 3, 3, 3, 4, 4, 4, 4, 4, 4, 4, 2, 4, 4, 4, 4, 0, 2, 4, 4, 4, 4, 4, 4, 4, 4, 4, 4, 4, 4, 4, 4, 4, 4, 2, 4, 4, 4],
      [4, 4, 4, 4, 4, 3, 3, 3, 3, 3, 3, 3, 3, 3, 3, 3, 4, 4, 4, 4, 4, 4, 4, 2, 4, 4, 4, 4, 0, 2, 4, 4, 4, 4, 4, 4, 4, 4, 4, 4, 4, 4, 4, 4, 4, 4, 2, 4, 4, 4],
      [4, 4, 4, 4, 4, 3, 3, 3, 3, 3, 3, 3, 3, 3, 3, 3, 4, 4, 4, 4, 4, 4, 4, 2, 4, 4, 4, 4, 0, 2, 2, 0, 2, 0, 0, 2, 0, 2, 2, 0, 2, 0, 0, 2, 0, 2, 2, 4, 4, 4],
      [4, 4, 4, 3, 3, 3, 3, 3, 3, 3, 3, 3, 3, 3, 3, 3, 4, 4, 2, 2, 2, 0, 2, 2, 0, 2, 0, 2, 0, 2, 2, 0, 2, 0, 0, 2, 0, 2, 2, 0, 2, 0, 0, 2, 0, 5, 2, 4, 4, 4],
      [4, 4, 4, 3, 3, 3, 3, 3, 3, 3, 3, 3, 3, 3, 3, 3, 4, 4, 2, 2, 2, 4, 4, 4, 4, 4, 4, 4, 0, 2, 4, 4, 4, 4, 4, 4, 4, 4, 4, 4, 4, 4, 4, 4, 4, 4, 2, 5, 4, 4],
      [4, 4, 4, 3, 3, 4, 4, 4, 4, 4, 4, 4, 4, 4, 4, 4, 4, 4, 2, 2, 2, 4, 4, 4, 4, 4, 4, 4, 0, 2, 4, 4, 2, 4, 4, 4, 4, 3, 3, 3, 3, 3, 3, 4, 4, 4, 2, 2, 4, 4],
      [4, 4, 4, 3, 3, 4, 4, 4, 4, 4, 4, 4, 4, 4, 4, 4, 4, 4, 4, 4, 4, 4, 4, 4, 4, 4, 4, 4, 0, 2, 4, 4, 2, 4, 4, 4, 4, 3, 3, 3, 3, 3, 3, 4, 4, 4, 4, 2, 4, 4],
      [4, 4, 4, 3, 3, 4, 4, 4, 4, 4, 4, 4, 4, 4, 4, 4, 4, 4, 4, 4, 4, 4, 4, 4, 2, 0, 2, 5, 0, 2, 0, 5, 0, 4, 4, 4, 4, 3, 3, 3, 3, 3, 3, 2, 0, 0, 2, 0, 2, 4],
      [4, 4, 4, 4, 4, 4, 4, 4, 4, 4, 4, 4, 4, 4, 4, 4, 4, 4, 4, 4, 4, 4, 4, 4, 4, 4, 4, 4, 4, 4, 4, 4, 4, 4, 4, 4, 4, 4, 4, 4, 4, 4, 4, 4, 4, 4, 4, 4, 4, 4]
    ]
  },
  "hero": {
    "HERO_NAME": "",
    "HERO_X_POSITION": 1,
    "HERO_Y_POSITION": 1,
    "HERO_SPEED": 3,
    "MAXIMUM_HEALTH": 6,
    "CURRENT_HEALTH": 6,
    "HAS_KEY": 0,
    "HAS_SPECIAL_KEY": 0,
    "HAS_MAP": true,
    "HAS_ENCHANTED_SWORD": false
  },
  "npc": {
    "NPC_X_POSITION": 2,
    "NPC_Y_POSITION": 2,
    "NPC_SPEED": 1
  },
  "objects": [
    {
      "type": "KeyObject",
      "position": {
        "positionX": 16,
        "positionY": 7
      }
    },
    {
      "type": "SpecialKeyObject",
      "position": {
        "positionX": 5,
        "positionY": 37
      }
    },
    {
      "type": "GateObject",
      "position": {
        "positionX": 3,
        "positionY": 49
      }
    },
    {
      "type": "ChestObject",
      "position": {
        "positionX": 1,
        "positionY": 15
      }
    },
    {
      "type": "MapObject",
      "position": {
        "positionX": 37,
        "positionY": 48
      }
    },
    {
      "type": "SpeedPotionObject",
      "position": {
        "positionX": 10,
        "positionY": 15
      }
    },
    {
      "type": "HealPotionObject",
      "position": {
        "positionX": 44,
        "positionY": 31
      }
    },
    {
      "type": "HealPotionObject",
      "position": {
        "positionX": 32,
        "positionY": 46
      }
    },
    {
      "type": "HealPotionObject",
      "position": {
        "positionX": 18,
        "positionY": 46
      }
    }
  ],
  "monsters": [
    {
      "NAME": "MonsterSlime",
      "SPEED": 1,
      "MAXIMUM_HEALTH": 4,
      "CURRENT_HEALTH": 4,
      "position": {
        "positionX": 47,
        "positionY": 2
      }
    },
    {
      "NAME": "MonsterSlime",
      "SPEED": 1,
      "MAXIMUM_HEALTH": 4,
      "CURRENT_HEALTH": 4,
      "position": {
        "positionX": 21,
        "positionY": 21
      }
    },
    {
      "NAME": "MonsterSlime",
      "SPEED": 1,
      "MAXIMUM_HEALTH": 4,
      "CURRENT_HEALTH": 4,
      "position": {
        "positionX": 19,
        "positionY": 21
      }
    },
    {
      "NAME": "MonsterZombie",
      "SPEED": 1,
      "MAXIMUM_HEALTH": 4,
      "CURRENT_HEALTH": 4,
      "position": {
        "positionX": 47,
        "positionY": 13
      }
    },
    {
      "NAME": "MonsterZombie",
      "SPEED": 1,
      "MAXIMUM_HEALTH": 4,
      "CURRENT_HEALTH": 4,
      "position": {
        "positionX": 19,
        "positionY": 10
      }
    }
  ]
}